NO ./images/north.xpm                                   
SO ./images/south.xpm                                   
WE ./images/west.xpm                                    
EA ./images/east.xpm
                     
F 220,100,0                                             
C 225,30,0                                              
                                                        
        111111111111111111111111111111111111111111111111
        100000000011000000000000000000000000000000000001
        101100000111000000000000000000000000000000000001
        100100000000000000000000000000000000000000000001
11111111101100000111000000000000000000000000000000000001
10000000001100000111011111111111111111111111111111111111
11110111111111111101110000001                           
11110111111111011101010010201                           
11000000110101011100000010001                           
10202000000000000000000010001                           
10000000000000001101010010001                           
11000001110101011111011110N0111                         
11110111 1110101 101111010001                           
11111111 1111111 111111111111
