EA ./images/east.xpm
NO ./images/north.xpm
WE ./images/west.xpm
SO ./images/south.xpm









C 255,30,0
F 123,100,0


        111111111111111111111111111011111111111111111111
        10000000001100000000000000000000000000000000011
        101100000111000000000000000000000000000000000001
        100100000000000000000000000000000000000000000001
11111111101100000111000000000000000000000000000000000001
11111111111111111111111111111111111111111111111111111111
1110111111111111101110000001100000001111
11111111111111111111111111111111111111111111
111000000110101011100000010001111111111111111111
10101000000000000000000010001
10000000000000001101010010001
110000011101010111101111N0011
111101111110101 1011110100011
111111111111111 1111111111111
